1 13 31
# # # # # # # # # # # # # # # # # # # # # # # # # # # # # # #
# p + + + + + * * + * + + + + * + + + * + + * + * + * + + + #
# + # + # + # * # + # + # * # * # + # + # + # * # * # * # + #
# + + x * + + + + + * * * + + * + + + + + + * + + + * + * + #
# + # + # + # + # + # * # + # + # * # * # + # + # + # + # * #
# f + + + f + + + + + x + * * + + * + + * + + + + + + + + + #
# + # + # + # + # + # + # + # + # + # * # + # * # + # + # + #
# * + + * + + + + + + * + + * + + + + + + * + + + + + + + + #
# + # + # + # + # * # + # + # + # * # * # + # + # + # + # + #
# * + + + + * * + + * + + + + + + + * + + + + + + * + + + + #
# + # * # + # + # + # + # + # + # * # + # + # + # + # + # + #
# + + + + + + + + + + + * + + + * + + * + + + + + + + + + + #
# # # # # # # # # # # # # # # # # # # # # # # # # # # # # # #